{
  "en": 0,
  "kk": 1,
  "tt": 2,
  "ru": 3,
  "ar": 4,
  "tr": 5,
  "it": 6,
  "de": 7,
  "es": 8,
  "fr": 9,
  "pl": 10,
  "nl": 11,
  "fa": 12,
  "rw": 13,
  "ca": 14
}